11111111111111111111111111111111111111111111111111
11111111111111111111111111111111111111111111111111
11111111111111111111111111111111111111111111111111
11111111111111111111111111111111111111111111111111
11111111111111111111111141004111111111111111111111
11111111111111111111111411111411111111111111111111
11114411114411111111100111111114111144114411114411
11111111111111100111111111111111411111111111111111
21111111111111111111111111111111141111111111111113
00001100001100000001100000001100000011000000001100
