21100010000100010000
00111011111100001000
00100010000110011100
01101010000111000100
01000011110001111100
01001110001111000000
01101101001000000000
00101001001111111000
00001110000000001000
01001011111111111000
01010101010000000000
01111100111111100000
00000111100000111110
01000001101110000010
01100110001111111110
01110110011000000000
00000010010000000000
00101000011111000000
01010000100001100000
31100100100000011111
